7:6
0 0 18 0 17 0 49 
0 17 17 0 17 0 0 
0 0 17 0 0 0 17 
0 17 0 18 0 0 17 
0 0 38 0 0 0 17 
32 17 17 18 0 0 18 
